                                                                                                                              
  {######################}       {######################}       {######################}     {########################}       
  {## ##                 }       {    ##  ##       ##   }       {                      }     {                        }       
  {                      }       {    ##  ##       ##   }       {                      }     {                        }       
  {                      }       {                      }       {                      }     {                        }       
  {    #########         }       {                      }       {                      }     {                        }       
  {#   {########}#####   }       {                      }       {                      }     {                        }       
  {#   {        } {} #   }       {                      }       {                      }     {                        }       
  {    {        } {} #   }       {                      }       {                      }     {                        }       
  {##  {        }        }       {                      }       {                      }     {                        }       
  {    {########}        }       {                      }       {                      }     {                        }       
  {  #        ####       }       {     {#  ##      {#}  }       {                      }     {                        }       
  {  #                   }       {     {#  ##      {#}  }       {                      }     {                        }       
  {   #######            }       {     {#  ##      {#}  }       {                      }     {                        }       
  {######################}       {######################}       {######################}     {########################}       
                                                                                                                              