                                                                                                                            
  {######################}       {######################}       {######################}     {######################}       
  {## ##                 }       {    ##  ##       ##   }       {                      }     {                      }       
  {#   #                 }       {    ##  ##       ##   }       {                      }     {                      }       
  {                      }       {                      }       {                      }     {                      }       
  {    #########         }       {                      }       {                      }     {                      }       
  {#   {########}#####   }       {                      }       {                      }     {                      }       
  {#   {        } {} #   }       {                      }       {                      }     {                      }       
  {    {        } {} #   }       {                      }       {                      }     {                      }       
  {##  {        }        }       {                      }       {                      }     {                      }       
  {    {########}        }       {                      }       {                      }     {                      }       
  {  #        ####       }       {     {#  ##      {#}  }       {                      }     {                      }       
  {  #                   }       {     {#  ##      {#}  }       {                      }     {                      }       
  {   #######            }       {     {#  ##      {#}  }       {                      }     {                      }       
  {######################}       {######################}       {######################}     {######################}       
                                                                                                                            
