                                                                                                                              
  {######################}       {######################}       {######################}       {######################}       
  {## ##                 }       {    ##  ##       ##   }       {                      }       {                      }       
  {                      }       {    ##  ##       ##   }       {                      }       {                      }       
  {                      }       {                      }       {                      }       {                      }       
  {    #########         }       {                      }       {                      }       {                      }       
  {#   {########}#####   }       {                      }       {                      }       {                      }       
  {#   {        } {} #   }       {                      }       {                      }       {                      }       
  {    {        } {} #   }       {                      }       {                      }       {                      }       
  {##  {        }        }       {                      }       {                      }       {                      }       
  {    {########}        }       {                      }       {                      }       {                      }       
  {  #        ####       }       {     {#  ##      {#}  }       {                      }       {                      }       
  {  #                   }       {     {#  ##      {#}  }       {                      }       {                      }       
  {   #######            }       {     {#  ##      {#}  }       {                      }       {                      }       
  {######################}       {######################}       {######################}       {######################}       
                                                                                                                              