                                                                
  {######################}       {######################}       
  {                      }       {                      }       
  {                      }       {                      }       
  {                      }       {                      }       
  {                      }       {                              
  {                      }       {                              
  {                      }       {                              
  {                      }       {                              
  {                      }       {                              
  {                      }       {                      }       
  {                      }       {                      }       
  {                      }       {                      }       
  {                      }       {                      }       
  {######################}       {######################}       
                                                                