                                                                                                                              
  {######################}       {######################}       {######################}       {######################}       
  {                      }       {    ##  ##       ##   }       {                      }       {                      }       
  {                      }       {    ##  ##       ##   }       {                      }       {                      }       
  {                      }       {    ##  ##       ##   }       {                      }       {                      }       
  {                      }       {                      }       {                      }       {                      }       
  {                      }       {                      }       {                      }       {                      }       
  {                      }       {                      }       {                      }       {                      }       
  {               {}     }       {                      }       {                      }       {                      }       
  {                      }       {                      }       {                      }       {                      }       
  {                      }       {                      }       {                      }       {                      }       
  {                      }       {     {#}{#}      {#}  }       {                      }       {                      }       
  {                      }       {     {#}{#}      {#}  }       {                      }       {                      }       
  {                      }       {     {#}{#}      {#}  }       {                      }       {                      }       
  {######################}       {######################}       {######################}       {######################}       
                                                                                                                              
